# 10x12 maze with walls marked with "-1"
0  0  0  0  0  0  0  0  0  0  0  0
0 -1  0  0  0  0 -1 -1  0 -1 -1  0
0 -1 -1  0  0  0 -1 -1  0  0 -1  0
0  0 -1 -1 -1 -1 -1  0  0 -1 -1  0
0  0  0  0 -1  0  0  0  0  0 -1  0
0  0 -1  0 -1  0 -1 -1 -1  0 -1  0
0 -1  0  0  0  0  0 -1 -1  0  0  0
0 -1 -1  0 -1 -1 -1  0 -1 -1  0  0
0  0 -1  0  0 -1 -1  0  0 -1 -1  0
0  0  0  0  0  0  0  0  0  0  0  0

#coords: row0 col0 row1 col1
0 0 9 11